***************
*A*   *     * *
* * * * * * * *
*   *   * *   *
* ******* *** *
* *       *  B*
***************